512 192 # Map size
16 16 # Tile size
32 12 # Matrix size
33 # Unique tiles
6 x 6 # Unique tiles grid
0 1 1 1 1 1 2 3 1 1 1 1 1 1 1 1 4 5 1 1 4 5 1 1 1 1 1 1 1 1 6 6
7 1 1 8 1 1 2 5 1 1 9 1 9 1 9 1 2 5 1 8 2 3 1 1 1 1 9 1 9 1 1 7
7 1 10 11 1 1 4 5 1 1 1 1 1 1 1 1 4 5 10 11 2 3 1 1 1 1 1 1 1 1 1 7
7 1 1 1 1 1 12 13 1 1 1 1 14 15 14 15 2 3 14 15 2 3 1 1 1 8 1 1 1 1 1 7
6 6 6 6 6 6 6 6 1 1 1 1 7 16 7 16 2 3 7 16 2 3 1 1 10 11 6 6 6 6 6 6
0 1 14 15 14 15 2 3 1 1 17 18 1 1 14 15 19 20 19 20 6 6 1 1 17 18 1 1 1 8 21 22
0 1 7 16 7 16 2 3 6 6 6 23 24 25 7 16 20 20 20 20 26 27 6 6 6 23 24 25 10 11 21 22
0 1 1 1 1 1 2 5 14 15 2 3 28 18 1 1 19 20 19 20 2 5 14 15 2 3 28 18 1 1 21 22
0 1 1 1 1 1 4 5 7 16 2 3 29 28 24 25 7 20 20 20 4 5 7 16 2 3 29 28 24 25 21 22
0 1 17 18 1 1 12 13 1 1 12 13 1 30 28 31 7 20 19 20 12 13 17 18 12 13 1 30 28 31 32 22
6 6 6 23 6 6 6 6 6 6 6 6 6 6 6 6 20 20 20 20 6 6 6 23 6 6 6 6 6 6 6 6
7 7 7 7 7 7 7 7 7 7 7 7 7 7 7 7 7 7 7 7 7 7 7 7 7 7 7 7 7 7 7 7
