1, 2, 2, 2, 2, 2, 1, 1, 1, 3, 4, 5, 6, 7, 1, 1, 
1, 1, 1, 1, 8, 9, 10, 11,
12, 12, 12, 12, 12, 12, 2, 2, 13, 14, 15, 16, 17, 18, 19, 20, 
21, 22, 23, 24, 25, 26, 27, 28,
12, 29, 12, 12, 12, 12, 12, 12, 13, 30, 31, 16, 17, 18, 32, 33, 
34, 35, 36, 37, 38, 39, 40, 41,
29, 42, 29, 29, 29, 29, 29, 29, 43, 44, 45, 46, 47, 48, 49, 50, 
51, 52, 53, 54, 55, 56, 57, 28,
58, 59, 60, 58, 58, 60, 58, 60, 61, 62, 63, 64, 65, 66, 67, 68, 
69, 70, 71, 72, 73, 74, 75, 76,
77, 77, 77, 77, 77, 77, 77, 77, 78, 79, 80, 81, 82, 83, 84, 85, 
85, 86, 87, 88, 89, 90, 91, 92