512 192 # Map size
16 16 # Tile size
32 12 # Matrix size
27 # Unique tiles
6 5 # Unique tiles grid
0 0 1 2 3 3 0 0 3 3 3 3 0 0 3 3 0 0 3 3 4 5 1 2 3 3 3 3 4 5 6 7
4 5 8 1 2 3 4 5 3 3 3 3 4 5 3 3 4 5 3 3 9 10 8 1 2 3 3 3 9 10 6 7
9 10 8 8 1 2 9 11 3 3 3 3 9 11 3 3 9 10 3 3 9 10 8 8 1 2 3 3 9 10 6 7
9 10 8 8 8 1 12 11 3 3 3 3 12 11 3 3 9 10 3 3 9 10 8 8 8 1 2 3 9 10 6 7
9 11 8 8 8 8 0 0 3 3 3 3 9 11 3 3 9 10 3 3 9 10 8 8 8 8 1 2 9 10 6 7
12 11 8 8 8 8 4 5 3 3 3 3 12 11 3 3 9 10 3 3 9 10 8 8 8 8 8 1 9 10 6 7
0 0 0 0 0 0 0 0 0 0 0 0 0 0 3 3 0 0 3 3 0 0 0 0 0 0 0 0 0 -1 6 7
4 5 13 14 13 14 4 5 15 16 13 14 4 5 3 3 4 5 3 3 4 5 13 14 13 14 13 14 4 5 6 7
9 11 3 3 3 3 9 11 17 18 19 19 9 10 3 20 9 10 3 20 9 10 19 19 3 20 3 3 9 10 0 0
12 11 3 3 3 3 12 11 3 3 19 19 9 10 21 22 9 10 21 22 9 10 19 19 21 22 3 3 9 10 13 14
23 24 23 24 23 24 23 24 23 24 23 24 23 24 23 24 23 24 23 24 23 24 23 24 23 24 23 24 0 0 23 24
25 26 25 26 25 26 25 26 25 26 25 26 25 26 25 26 25 26 25 26 25 26 25 26 25 26 25 26 4 5 25 26
0 
23 24 25 26	