1536 192 # Map size
16 16 # Tile size
96 12 # Matrix size
67 # Unique tiles
9 8 # Unique tiles grid
0 1 2 3 4 5 0 1 0 1 2 3 4 5 0 1 0 1 2 3 6 7 0 1 0 1 2 3 4 5 0 1 8 9 2 3 4 5 8 9 0 1 0 1 0 1 0 1 2 3 4 5 10 10 2 3 11 12 0 1 0 1 8 9 2 3 8 9 2 3 8 9 2 3 8 9 2 3 0 1 8 9 0 1 11 12 11 12 0 1 10 10 2 3 13 14
15 16 2 3 17 18 19 20 21 22 2 3 17 18 19 20 21 22 2 3 6 23 19 20 21 22 2 3 17 18 19 20 15 16 2 3 17 18 10 10 21 22 21 22 21 22 21 22 2 3 24 25 10 10 2 3 21 22 21 22 21 22 15 16 2 3 10 10 2 3 10 10 2 3 10 10 2 3 21 22 10 10 21 22 21 22 21 22 21 22 10 10 2 3 26 27
11 12 2 3 28 29 8 9 0 1 2 3 28 29 8 9 0 1 2 3 4 5 8 9 0 1 2 3 28 29 8 9 11 12 2 3 28 29 10 10 0 1 0 1 0 1 0 1 2 3 30 31 10 10 2 3 0 1 0 1 0 1 11 12 2 3 10 10 2 3 10 10 2 3 10 10 2 3 0 1 10 10 0 1 0 1 0 1 0 1 10 10 2 3 26 27
21 22 2 3 24 25 10 10 21 22 2 3 17 18 10 10 21 22 2 3 17 18 10 10 21 22 2 3 17 18 10 10 21 22 2 3 17 18 10 10 21 22 21 22 32 33 34 35 36 37 38 39 40 40 40 40 41 42 43 44 21 22 21 22 2 3 10 10 2 3 10 10 2 3 10 10 2 3 19 20 10 10 21 22 32 33 34 35 40 40 38 39 36 37 26 27
0 1 2 3 30 31 10 10 0 1 2 3 28 29 10 10 0 1 2 3 28 29 10 10 0 1 2 3 28 29 10 10 0 1 2 3 28 29 10 10 0 1 0 1 45 34 46 47 47 47 47 47 47 47 47 47 47 48 49 50 0 1 0 1 2 3 10 10 2 3 10 10 2 3 10 10 2 3 8 9 10 10 0 1 45 34 46 47 47 47 47 47 47 47 47 47
21 22 2 3 21 22 10 10 21 22 2 3 24 25 10 10 19 20 2 3 17 18 10 10 21 22 2 3 24 25 10 10 21 22 2 3 17 18 10 10 32 33 34 35 51 46 52 53 2 3 21 22 15 16 2 3 54 55 48 56 38 39 40 40 2 3 10 10 2 3 10 10 2 3 10 10 2 3 15 16 10 10 32 33 57 46 52 53 21 22 21 22 58 59 60 14
0 1 2 3 0 1 10 10 0 1 2 3 30 31 10 10 8 9 2 3 28 29 10 10 0 1 2 3 30 31 10 10 0 1 2 3 28 29 10 10 45 34 46 47 47 47 61 62 2 3 0 1 11 12 2 3 63 64 47 47 47 47 47 27 2 3 10 10 2 3 10 10 2 3 10 10 2 3 11 12 10 10 45 34 46 65 61 62 0 1 0 1 2 3 13 14
21 22 2 3 21 22 10 10 19 20 2 3 21 22 10 10 15 16 2 3 24 25 10 10 21 22 2 3 21 22 10 10 15 16 2 3 24 25 32 33 57 46 52 53 19 20 21 22 2 3 21 22 21 22 2 3 21 22 2 3 19 20 19 20 2 3 10 10 2 3 10 10 2 3 10 10 2 3 19 20 32 33 57 46 52 53 19 20 21 22 21 22 2 3 60 14
0 1 2 3 0 1 10 10 8 9 2 3 0 1 10 10 11 12 2 3 30 31 10 10 0 1 2 3 0 1 10 10 11 12 2 3 30 31 45 34 46 65 61 62 8 9 0 1 2 3 0 1 0 1 2 3 0 1 2 3 8 9 8 9 2 3 10 10 2 3 10 10 2 3 10 10 2 3 8 9 45 34 46 65 61 62 8 9 0 1 0 1 2 3 13 14
38 39 36 37 38 39 38 39 38 39 36 37 38 39 38 39 38 39 36 37 38 39 38 39 38 39 36 37 38 39 38 39 38 39 36 37 38 39 51 46 38 39 38 39 38 39 38 39 36 37 38 39 38 39 36 37 38 39 36 37 38 39 38 39 36 37 38 39 36 37 38 39 36 37 38 39 36 37 38 39 51 46 38 39 38 39 38 39 38 39 38 39 36 37 66 14
47 47 47 47 47 47 47 47 47 47 47 47 47 47 47 47 47 47 47 47 47 47 47 47 47 47 47 47 47 47 47 47 47 47 47 47 47 47 47 47 47 47 47 47 47 47 47 47 47 47 47 47 47 47 47 47 47 47 47 47 47 47 47 47 47 47 47 47 47 47 47 47 47 47 47 47 47 47 47 47 47 47 47 47 47 47 47 47 47 47 47 47 47 47 47 47
27 27 27 27 27 27 27 27 27 27 27 27 27 27 27 27 27 27 27 27 27 27 27 27 27 27 27 27 27 27 27 27 27 27 27 27 27 27 27 27 27 27 27 27 27 27 27 27 27 27 27 27 27 27 27 27 27 27 27 27 27 27 27 27 27 27 27 27 27 27 27 27 27 27 27 27 27 27 27 27 27 27 27 27 27 27 27 27 27 27 27 27 27 27 27 27
