768 192 # Map size
16 16 # Tile size
48 12 # Matrix size
77 # Unique tiles
9 9 # Unique tiles grid
0 1 0 1 2 3 4 5 0 1 2 3 6 7 0 1 2 3 8 9 10 11 12 13 0 1 14 15 2 3 12 13 0 1 14 15 2 3 12 13 0 1 16 17 6 7 18 19
20 21 22 23 2 3 20 21 20 21 2 3 24 24 20 21 2 3 25 26 22 23 20 21 27 28 29 30 2 3 31 32 27 28 29 30 2 3 31 32 27 28 16 33 24 24 34 19
0 1 4 5 2 3 0 1 0 1 2 3 24 24 0 1 2 3 35 36 4 5 0 1 2 3 14 15 2 3 12 13 2 3 14 15 2 3 12 13 2 3 8 9 24 24 18 19
37 38 39 39 39 39 40 41 42 43 2 3 24 24 20 21 2 3 44 45 20 21 20 21 2 3 20 21 2 3 20 21 2 3 20 21 2 3 46 47 2 3 44 45 24 24 48 49
50 50 50 50 50 50 50 51 52 53 2 3 24 24 0 1 2 3 54 55 0 1 0 1 2 3 0 1 2 3 0 1 2 3 0 1 2 3 6 7 2 3 54 55 24 24 48 56
16 33 20 21 27 28 57 58 51 59 39 39 37 38 39 39 39 39 40 41 42 43 20 21 2 3 20 21 2 3 20 21 2 3 20 21 2 3 22 23 2 3 60 61 62 63 48 64
8 9 0 1 2 3 10 11 50 50 50 50 50 50 50 50 50 50 50 51 52 53 0 1 2 3 0 1 2 3 0 1 2 3 0 1 2 3 4 5 2 3 65 62 66 50 50 50
44 45 20 21 2 3 20 21 46 47 2 3 22 23 2 3 22 23 57 58 51 52 42 43 2 3 20 21 2 3 20 21 2 3 20 21 2 3 20 21 2 3 67 66 68 69 34 19
54 55 0 1 2 3 0 1 6 7 2 3 4 5 2 3 4 5 10 11 70 51 52 53 2 3 0 1 2 3 0 1 2 3 0 1 2 3 0 1 2 3 50 71 72 73 18 19
37 38 37 38 74 75 37 38 37 38 74 75 37 38 74 75 37 38 37 38 37 38 51 59 74 75 37 38 74 75 37 38 74 75 37 38 74 75 37 38 74 75 37 38 37 38 76 19
50 50 50 50 50 50 50 50 50 50 50 50 50 50 50 50 50 50 50 50 50 50 50 50 50 50 50 50 50 50 50 50 50 50 50 50 50 50 50 50 50 50 50 50 50 50 50 50
71 71 71 71 71 71 71 71 71 71 71 71 71 71 71 71 71 71 71 71 71 71 71 71 71 71 71 71 71 71 71 71 71 71 71 71 71 71 71 71 71 71 71 71 71 71 71 71
